PATID,sex,Age_symptom_onset,AOA1,AA1,CD8T,CD4T,Bcell,Gran,Status1,relatedness,AA,interval,AO
40586,2,36,39,13.49,0.12817629,0.069576005,0.040420382,0.454463971,1,1,2,3,36
40595,1,40,47,8.75,0.102918156,0.207685166,0.016812488,0.400793454,1,5,2,7,40
41412,1,41,45,7.15,0.119087165,0.0956891,0.017099077,0.546597177,1,66,2,4,41
41410,1,43,44,14.26,0.085842277,0.101041771,0.012548906,0.565604063,1,65,2,1,43
42171,2,43,47,11.96,0.11468701,0.05194485,0.061786774,0.533213498,1,83,2,4,43
41399,1,44,49,6.34,0.094157735,0.180013689,0.039083123,0.494963049,1,8,2,5,44
41400,1,44,50,8.57,0.083780446,0.142966874,0.035807342,0.517471237,1,64,2,6,44
40592,1,45,52,16.99,0.065862159,0.072377108,0.003156165,0.588591204,1,3,2,7,45
40781,2,46,49,6.95,0.069073233,0.156325824,0.069584168,0.506961083,1,41,2,3,46
50044,1,46,58,3.04,0.064587076,0.121585441,0.004751495,0.587956417,1,95,2,12,46
52062,2,46,48,15.76,0.109228433,0.101077646,0.019080217,0.501130422,1,132,2,2,46
40585,2,47,52,7.04,0.147187889,0.14936678,0.05180779,0.408097453,1,32,2,5,47
42351,2,47,49,9.37,0.094094482,0.073697011,0.034414414,0.527155209,1,87,2,2,47
42455,2,47,57,8.22,0.089829682,0.050951468,0.03001795,0.592004932,1,93,2,10,47
40578,2,48,51,12.92,0.116408622,0.145757522,0.010110634,0.445357813,1,31,2,3,48
40671,2,48,60,6.62,0.229352819,0.06494398,0.01045552,0.427238111,1,14,2,12,48
41295,1,48,50,13.16,0.168155446,0.124950278,0.026650308,0.477800851,1,54,2,2,48
41282,1,49,55,3.04,0.040300464,0.1210393,0.043058711,0.607242558,1,47,2,6,49
50319,2,50,53,6.44,0.056373026,0.131438901,0.016154424,0.574989545,1,104,2,3,50
51625,1,50,53,5.55,0.113007443,0.117562448,0.023398728,0.536662331,1,125,2,3,50
54197,2,50,68,-2.18,0.086969731,0.145787254,0.120563693,0.454803947,1,150,1,18,50
40603,1,51,55,0.07,0.09496614,0.152187091,0,0.510746058,1,6,1,4,51
41985,2,51,56,5.12,0.146523307,0.144958853,0.086262213,0.395544063,1,77,2,5,51
42346,2,51,55,7.04,0.154921415,0.071458698,0.043219939,0.506317847,1,86,2,4,51
50901,2,51,52,9.08,0.08882767,0.079513187,0.034454997,0.576306757,1,115,2,1,51
40599,1,52,58,2.97,0.0447792,0.130531186,0.064062714,0.466893187,1,7,1,6,52
40555,1,53,57,3.5,0.073673509,0.108767207,0.040990163,0.595844406,1,25,2,4,53
41380,1,54,60,2.39,0.070428871,0.203369696,0.005811881,0.536523738,1,61,1,6,54
41305,1,56,65,11.9,0.06283214,0.185714429,0.038795423,0.521435465,1,57,2,9,56
41382,2,56,59,5.64,0.069559188,0.085428174,0.002158819,0.612388183,1,62,2,3,56
41384,1,56,61,3.89,0.084979213,0.124912984,0.026235315,0.51791416,1,63,2,5,56
41522,1,56,58,8.69,0.144829621,0.132574771,0.025786834,0.468462004,1,72,2,2,56
41749,1,56,59,8.86,0.010343361,0.187176713,0.045192667,0.550619874,1,74,2,3,56
50157,1,56,61,6,0.035431443,0.176082767,0.0191253,0.550422779,1,99,2,5,56
50485,1,56,64,3.31,0.065188065,0.095744047,0.013519006,0.613217159,1,13,2,8,56
50621,2,56,60,5.07,0.108464921,0.170427313,0.029303072,0.485744894,1,112,2,4,56
40553,1,57,69,1.44,0.042292352,0.181802045,0.012165134,0.528401226,1,9,1,12,57
41420,2,57,64,1.16,0.088151736,0.162201505,0.012038874,0.486662726,1,10,1,7,57
42448,1,57,63,4.68,0.086421595,0.068523592,0.024580607,0.622043167,1,92,2,6,57
40366,2,58,63,6.11,0.079837846,0.212777003,0.028047367,0.443682229,1,22,2,5,58
51971,2,58,66,2.89,0.064942616,0.110443674,0.022901397,0.537010593,1,131,1,8,58
53595,1,58,65,-5.37,0.092174646,0.174972201,0.037634728,0.522519239,1,145,0,7,58
55251,2,58,59,7.45,0.069458822,0.168577018,0.061561621,0.415347308,1,156,2,1,58
50028,1,59,63,0.6,0.063261417,0.171446732,0.064662425,0.507244576,1,94,1,4,59
50192,2,59,62,7.25,0.056794542,0.104041882,0.053158692,0.560018936,1,102,2,3,59
59507,2,59,69,2.59,0.070029406,0.059188503,0.101150158,0.612224033,1,193,1,10,59
70818,2,59,65,6.5,0.100516463,0.148871914,0.024046904,0.493827695,1,200,2,6,59
42429,1,60,68,1.55,0.1321709,0.108127877,0.059517368,0.463874687,1,88,1,8,60
50088,1,60,63,11.38,0.107229078,0.126133009,0.020946548,0.550261551,1,96,2,3,60
50175,2,60,62,10.82,0.086547211,0.209615508,0.0386599,0.410132062,1,101,2,2,60
51186,1,60,66,-0.16,0.08334639,0.2047744,0.031114211,0.478319394,1,117,1,6,60
51518,1,60,63,4.06,0.123601644,0.131577281,0.039082931,0.532930665,1,124,2,3,60
59724,1,60,67,-0.58,0.045536012,0.099568047,0.030923409,0.56584317,1,194,1,7,60
3173,1,61,63,0.83,0.292088803,0.028975496,0.038937931,0.441027631,1,20,1,2,61
40560,1,61,66,-1.98,0.11227316,0.037698775,0.005110419,0.608054995,1,27,1,5,61
40882,1,61,62,-1.41,0.030991531,0.194264217,0.033679032,0.496483279,1,44,1,1,61
41486,2,61,64,1.21,0.035482212,0.140661633,0,0.545441315,1,68,1,3,61
50509,1,61,63,5.51,0.034894908,0.279532313,0.012894092,0.484158247,1,109,2,2,61
40709,1,62,64,-0.28,0.175451424,0.118003794,0.038735252,0.404899995,1,40,1,2,62
50860,2,62,69,3.77,0.082272532,0.07336977,0.051093229,0.52780914,1,114,2,7,62
51252,1,62,65,3.64,0.211766169,0.068662017,0.009496065,0.418498332,1,119,2,3,62
55395,1,62,67,11.25,0.188172124,0.180548378,0.062530837,0.434124947,1,158,2,5,62
70463,2,62,67,0.07,0.129836915,0.162107602,0.050718393,0.452791234,1,198,1,5,62
41287,2,63,71,0.63,0.105109737,0.145619418,0.003645734,0.476036056,1,50,1,8,63
50746,1,63,66,2.76,0.089636479,0.126714814,0.004418403,0.56263449,1,113,1,3,63
58671,2,63,68,-1.11,0.078630093,0.138301075,0.057127051,0.45255581,1,185,1,5,63
40558,2,64,69,1.97,0.092712947,0.11542071,0.009651382,0.536343431,1,26,1,5,64
40607,2,64,70,1.88,0.060047307,0.13044085,0,0.516366066,1,34,1,6,64
41285,1,64,68,-4.87,0.228058199,0.11832494,0.017324221,0.428827137,1,49,0,4,64
41829,2,64,71,3.91,0.116628416,0.079719201,0.012163282,0.563288191,1,76,2,7,64
40707,1,65,68,1.91,0.040528847,0.137323037,0.025858544,0.581976901,1,39,1,3,65
41289,1,65,67,1.39,0.151999226,0.054050006,0.035923327,0.541626666,1,51,1,2,65
41293,2,65,68,1.38,0.060118609,0.062618613,0.007782024,0.597474553,1,53,1,3,65
58550,2,65,73,1.28,0.143267874,0.057696361,0.033904137,0.535591284,1,183,1,8,65
41488,2,67,70,3.74,0.048190523,0.101595226,0.028288095,0.58784969,1,69,2,3,67
41521,1,67,72,2.16,0.072907917,0.147928467,0.033153836,0.503602628,1,71,1,5,67
51440,2,67,70,10.14,0.076998933,0.1483333,0.032492021,0.449935512,1,123,2,3,67
52530,2,67,69,3.08,0.142947063,0.161337694,0,0.455254209,1,137,2,2,67
40816,2,68,71,1.93,0.119018569,0.067751746,0.004962448,0.555622956,1,43,1,3,68
41578,1,68,69,3.51,0.073254509,0.092342341,0.042809101,0.582094846,1,73,2,1,68
41508,1,69,75,-1.34,0.095998638,0.144375789,0.008308394,0.530031992,1,70,1,6,69
71978,1,69,72,-3.08,0.039261514,0.195348447,0.013365833,0.597322036,1,202,0,3,69
41184,2,70,73,-10.08,0.090230638,0.14668485,0.070723542,0.479669418,1,46,0,3,70
52128,2,70,73,-4.21,0.033426536,0.150730448,0.030073454,0.519145821,1,133,0,3,70
56169,1,70,79,-9.95,0.102842382,0.079829275,0.04241935,0.554683007,1,18,0,9,70
40691,1,71,75,2.7,0.086405546,0.046532036,0.040355419,0.540233335,1,38,1,4,71
58431,2,72,77,-3,0.058344761,0.05485035,0.006758493,0.579497242,1,182,0,5,72
72784,1,72,76,-1.21,0.103437805,0.128144743,0.019947521,0.473064575,1,203,1,4,72
40800,2,73,79,-4.46,0.047112609,0.128503594,0.011622854,0.57889292,1,42,0,6,73
50983,2,73,74,2.45,0.103293113,0.073106562,0.016514979,0.58528961,1,116,1,1,73
41767,1,75,77,-12.3,0.075370088,0.087701412,0.032014982,0.595005054,1,75,0,2,75